###############Mod

#yet incorporated







RED = "countries/Redbox.txt"








####Russia
VED = "countries/Vedra.txt"
ROV = "countries/Roviet"
RSK = "countries/Riskalite.txt"
TVR = "countries/Tver.txt"
##############################


WOW = "countries/Wow.txt"
DMO = "countries/Domo.txt"
LOS = "countries/Los.txt"
INJ = "countries/Injuid.txt"
PEP = "countries/Peep.txt"






####Persian States
LRD = "countries/Lord.txt"
AUV = "countries/Auvergne.txt"
SON = "countries/Sonic.txt"
#############################



EXP = "countries/Experienced.txt"
HAN = "countries/HanEmpire.txt"
ENT = "countries/Entrepreneur.txt"
PAV = "countries/Pavalix.txt"
MNF = "countries/Manfred.txt"
ANC = "countries/Anarchy.txt"
VNZ = "countries/Venesuela.txt"
TRN = "countries/Trinitits.txt"
BLU = "countries/Bluelight.txt"
NOB = "countries/Noob.txt"
VNC = "countries/Venice.txt"
LEE = "countries/Molossia.txt"
IMP = "countries/Imp.txt"
JSH = "countries/Josiah.txt"
AMS = "countries/Amster.txt"
BRD = "countries/Bread.txt"
ARQ = "countries/Arquebus.txt"
PHL = "countries/Phil.txt"
PLX = "countries/Nicol.txt"
GNL = "countries/Pingu.txt"
GIT = "countries/Orange.txt"
ALX = "countries/Alexander.txt"
DOC = "countries/Carolina.txt"
MEM = "countries/Memeby.txt"
AGH = "countries/Halit.txt"
SHE = "countries/Sherman.txt"
ADM = "countries/Adam.txt"
RIO = "countries/Rioghail.txt"
DEW = "countries/Dew.txt"
TRV = "countries/Trivago.txt"
TKC = "countries/Takech.txt"
LEJ = "countries/Leejj.txt"
YAY = "countries/Yay.txt"
BUM = "countries/Bumhole.txt"
BOB = "countries/Bob.txt"
MIT = "countries/Mitsuhito.txt"
ROX = "countries/Rockoxe.txt"
TAG = "countries/Tag.txt"
TER = "countries/Ternovia.txt"
CEL = "countries/Supercell.txt"
ABA = "countries/Abarai.txt"
HWK = "countries/Hawk.txt"
WOR = "countries/Worthe.txt"
GUI = "countries/Guil.txt"
NNJ = "countries/Ninja.txt"
BOX = "countries/Boxxer.txt"
MRF = "countries/Marfit.txt"
PRS = "countries/Prestonk.txt"
BRY = "countries/Brycesony.txt"
ICY = "countries/Icebear.txt"
FSH = "countries/Flash.txt"
GAY = "countries/Stuff.txt"
FIR = "countries/Fire.txt"
OWN = "countries/Ownage.txt"
OMG = "countries/Omega.txt"
SUP = "countries/Super.txt"
AMN = "countries/Amnity.txt"
SUO = "countries/Suomi.txt"
ASA = "countries/Asatru.txt"
BEN = "countries/Benny.txt"
BLK = "countries/Blake.txt"
WYP = "countries/Wypr.txt"
JOO = "countries/Jono.txt"
CAS = "countries/Castlemore.txt"
SRY = "countries/Seryna.txt"
TOR = "countries/Tornadocracy.txt"
SPA = "countries/Spartan.txt"
LAN = "countries/Lancer.txt"
MYA = "countries/Miya.txt"
VAS = "countries/Vasily.txt"
FAG = "countries/Thunder.txt"
ZAB = "countries/Lance.txt"
BAT = "countries/BatonRogue.txt"
ECG = "countries/EpicCoolGuy.txt"
TOY = "countries/Toyofutusu.txt"
JOH = "countries/Johnsony.txt"
ROK = "countries/Phillipino.txt"
##################





